RELEASE_YEAR,GENRE,BUDGET,REVENUE,PROFIT,POPULARITY
1915,Drama,117311,11137365,11020054,5.7936119999999995
1915,History,100000,11000000,10900000,5.113205
1915,War,100000,11000000,10900000,5.113205
1916,Action,200000,8000000,7800000,0.917777
1916,Adventure,200000,8000000,7800000,0.917777
1916,Drama,200000,8000000,7800000,0.917777
1916,Science Fiction,200000,8000000,7800000,0.917777
1918,Comedy,250000,8000000,7750000,0.211008
1918,Drama,250000,8000000,7750000,0.211008
1921,Comedy,250000,2500000,2250000,8.168456
1921,Drama,250000,2500000,2250000,8.168456
1922,Drama,1100000,400200,-699800,0.838095
1924,Action,1135654,1213880,78226,3.878515
1924,Adventure,1135654,1213880,78226,3.878515
1924,Drama,1135654,1213880,78226,3.878515
1924,Family,1135654,1213880,78226,3.878515
1924,Fantasy,1135654,1213880,78226,3.878515
1925,Adventure,4823000,11500000,6677000,8.503139000000001
1925,Comedy,923000,2500000,1577000,6.202041
1925,Crime,103000,704000,601000,1.345287
1925,Drama,5171592,34204001,29032409,12.219772
1925,Romance,348592,22704001,22355409,3.716633
1925,War,245000,22000000,21755000,2.084627
1926,Drama,836455,1624878,788423,1.2108409999999998
1926,Romance,373000,658000,285000,0.765315
1927,Comedy,483103,1027757,544654,0.205671
1927,Drama,93103103,1678179,-91424924,14.693538
1927,Romance,483103,1027757,544654,0.205671
1927,Science Fiction,92620000,650422,-91969578,14.487867
1928,Adventure,290337,596551,306214,0.906421
1928,Crime,75000,1200000,1125000,0.251353
1928,Drama,624337,2717551,2093214,1.8802849999999998
1928,Mystery,259000,921000,662000,0.722511
1929,Drama,379000,4358000,3979000,0.758012
1929,Music,379000,4358000,3979000,0.758012
1929,Romance,379000,4358000,3979000,0.758012
1930,Action,3950000,8000000,4050000,5.276546
1930,Drama,3950000,8000000,4050000,5.276546
1930,History,3950000,8000000,4050000,5.276546
1931,Action,558000,2227000,1669000,1.41344
1931,Comedy,1500000,19181,-1480819,10.891524
1931,Drama,2349000,14246181,11897181,20.396567
1931,Horror,646000,13012189,12366189,15.594729
1931,Romance,2058000,2246181,188181,12.304964
1931,Science Fiction,291000,12000000,11709000,8.091603
1931,Thriller,558000,2227000,1669000,1.41344
1932,Drama,700008,2594050,1894042,15.444732
1932,Romance,700008,2594050,1894042,15.444732
1932,War,8,50,42,4.325888
1933,Action,672000,10000000,9328000,8.73274
1933,Adventure,672000,10000000,9328000,8.73274
1933,Comedy,864000,7331000,6467000,8.092291
1933,Drama,2966280,20240000,17273720,12.815318000000001
1933,History,1114000,2610000,1496000,2.886254
1933,Horror,672000,10000000,9328000,8.73274
1933,Music,439000,2281000,1842000,4.718154
1933,Romance,1778000,7741000,5963000,9.137787
1934,Comedy,551408,5923000,5371592,17.039124
1934,Crime,226408,1423000,1196592,10.573867
1934,Drama,947000,1120000,173000,0.631309
1934,Mystery,226408,1423000,1196592,10.573867
1934,Romance,1272000,5620000,4348000,7.096566
1935,Adventure,1950000,4460000,2510000,7.135215
1935,Comedy,609280,3202831,2593551,7.232894
1935,Drama,3345000,6849000,3504000,10.946285
1935,History,1950000,4460000,2510000,7.135215
1935,Music,609000,3202000,2593000,7.122093
1935,Mystery,280,831,551,0.110801
1935,Romance,3711280,9101831,5390551,16.178682999999996
1936,Action,1200000,2736000,1536000,5.39865
1936,Adventure,1200000,2736000,1536000,5.39865
1936,Comedy,886001,11100000,10213999,14.667152999999999
1936,Drama,4483001,19804000,15320999,19.74348
1936,History,1983000,3295000,1312000,5.41511
1936,Music,2186000,7873000,5687000,7.277761
1936,Romance,2186000,7873000,5687000,7.277761
1936,War,1200000,2736000,1536000,5.39865
1937,Animation,1488423,184925486,183437063,16.263878
1937,Family,1488423,184925486,183437063,16.263878
1937,Fantasy,1488423,184925486,183437063,16.263878
1938,Action,2033000,3981000,1948000,10.685036
1938,Adventure,2033000,3981000,1948000,10.685036
1938,Comedy,1644736,7433101,5788365,4.370592
1938,Drama,2000000,4000000,2000000,0.632261
1938,Music,2000000,4000000,2000000,0.632261
1938,Romance,5677736,15414101,9736365,15.687889
1939,Adventure,3308374,34858724,31550350,30.035394
1939,Comedy,4553000,14149000,9596000,18.365378999999997
1939,Drama,7188000,412046459,404858459,27.4857
1939,Family,2777000,33754967,30977967,22.064932
1939,Fantasy,2777000,33754967,30977967,22.064932
1939,Romance,5365000,402455459,397090459,19.360393
1939,War,4000000,400176459,396176459,14.240357
1939,Western,531374,1103757,572383,7.970462
1940,Adventure,2000000,9172000,7172000,1.52854
1940,Animation,4880000,167620000,162740000,22.240244
1940,Comedy,2000000,11000000,9000000,9.241748
1940,Drama,3288000,15172000,11884000,10.119353
1940,Family,4880000,167620000,162740000,22.240244
1940,Music,2280000,83320000,81040000,8.03796
1940,Mystery,1288000,6000000,4712000,8.590813
1940,Romance,2000000,9172000,7172000,1.52854
1941,Action,1400000,16361885,14961885,3.336494
1941,Animation,812000,1600000,788000,14.655879
1941,Crime,375000,1000000,625000,5.782544
1941,Drama,3489727,45579559,42089832,28.206993000000004
1941,Family,812000,1600000,788000,14.655879
1941,History,1400000,16361885,14961885,3.336494
1941,Mystery,2317727,28717674,26399947,27.254941
1941,Thriller,1478000,5500000,4022000,11.44302
1941,War,1400000,16361885,14961885,3.336494
1942,Adventure,322000,1040000,718000,1.48335
1942,Animation,858000,267447150,266589150,13.698132
1942,Comedy,322000,1040000,718000,1.48335
1942,Drama,4016000,299780650,295764650,42.197035
1942,Family,858000,267447150,266589150,13.698132
1942,Horror,134000,4000000,3866000,5.110716
1942,Music,802000,4371000,3569000,6.165341
1942,Romance,3346000,29373500,26027500,24.871537000000004
1942,Science Fiction,322000,1040000,718000,1.48335
1942,Thriller,134000,4000000,3866000,5.110716
1942,War,1666000,14540000,12874000,4.790095
1943,Fantasy,662141,1606624,944483,1.233446
1943,Music,662141,1606624,944483,1.233446
1943,Thriller,855000,1200000,345000,1.121417
1943,War,855000,1200000,345000,1.121417
1944,Comedy,2361000,6892000,4531000,0.789574
1944,Drama,7569262,11863000,4293738,17.814582
1944,History,2995000,2000000,-995000,0.773081
1944,Music,5356000,8892000,3536000,1.562655
1944,Mystery,1947262,4500000,2552738,16.378836
1944,Romance,5622000,7363000,1741000,1.435746
1944,Thriller,927262,2500000,1572738,6.49432
1944,War,2627000,5363000,2736000,0.662665
1945,Crime,1453000,5638000,4185000,4.497049
1945,Drama,7565007,35718386,28153379,25.29562
1945,Mystery,1500000,7000000,5500000,5.47596
1945,Thriller,1500000,7000000,5500000,5.47596
1946,Drama,7280000,57758866,50478866,31.236042
1946,Family,3180000,9644124,6464124,15.031588
1946,Fantasy,3180000,9644124,6464124,15.031588
1946,History,2100000,23650000,21550000,6.069343
1946,Romance,4100000,48114742,44014742,16.204454
1946,Thriller,2000000,24464742,22464742,10.135111
1946,Western,6000000,20400000,14400000,8.441279
1947,Drama,2000000,7800000,5800000,6.857318
1947,Romance,2000000,7800000,5800000,6.857318
1948,Action,5043000,7148000,2105000,11.873857000000001
1948,Adventure,3800000,4307000,507000,8.070589
1948,Comedy,784170,834332,50162,0.578456
1948,Crime,1500000,2200000,700000,7.248676
1948,Drama,7460170,10544044,3083874,32.934125
1948,Fantasy,784170,834332,50162,0.578456
1948,Music,3700000,2956000,-744000,1.830178
1948,Mystery,1500000,2200000,700000,7.248676
1948,Romance,4484170,3790332,-693838,2.408634
1948,Science Fiction,784170,834332,50162,0.578456
1948,Thriller,1500000,2200000,700000,7.248676
1948,Western,10543000,19160000,8617000,23.464016
1949,Action,1000000,7800000,6800000,2.828371
1949,Drama,4000000,19300000,15300000,5.357009
1949,History,1000000,7800000,6800000,2.828371
1949,Romance,3000000,11500000,8500000,2.528638
1949,War,1000000,7800000,6800000,2.828371
1949,Western,1600000,5400000,3800000,7.715087
1950,Action,3768785,8000000,4231215,2.090588
1950,Animation,2900000,263591415,260691415,14.436858
1950,Comedy,3768785,8000000,4231215,2.090588
1950,Crime,250000,96568,-153432,9.887355
1950,Drama,3402000,5160031,1758031,33.660212
1950,Family,2900000,263591415,260691415,14.436858
1950,Fantasy,2900000,263591415,260691415,14.436858
1950,Music,5883785,10039000,4155215,2.200501
1950,Mystery,250000,96568,-153432,9.887355
1950,Romance,6668785,271591415,264922630,16.527446
1950,Western,3768785,8000000,4231215,2.090588
1951,Adventure,4300000,582750000,578450000,23.125809
1951,Animation,3000000,572000000,569000000,16.488937
1951,Comedy,2723903,4500000,1776097,5.565203
1951,Crime,1200000,7000000,5800000,15.41773
1951,Drama,15794955,50800000,35005045,51.172048000000004
1951,Family,3000000,572000000,569000000,16.488937
1951,Fantasy,3000000,572000000,569000000,16.488937
1951,History,8250000,30000000,21750000,11.840985
1951,Music,5023903,15500000,10476097,7.5831930000000005
1951,Romance,14573903,56250000,41676097,26.06105
1951,Thriller,1200000,7000000,5800000,15.41773
1951,War,1300000,10750000,9450000,6.636872
1952,Action,7005000,42746000,35741000,7.81491
1952,Adventure,3005000,6746000,3741000,3.803547
1952,Comedy,2540800,7200000,4659200,11.064858
1952,Drama,7005000,42746000,35741000,7.81491
1952,Music,2540800,7200000,4659200,11.064858
1952,Romance,6540800,43200000,36659200,15.076221
1952,Western,730000,8000000,7270000,16.715935
1953,Action,1805000,4905000,3100000,12.90707
1953,Adventure,4210000,92404651,88194651,20.285590000000003
1953,Animation,4000000,87404651,83404651,16.861533
1953,Comedy,1500000,12000000,10500000,11.954806
1953,Crime,1908000,32300000,30392000,23.67747
1953,Drama,11905000,99905000,88000000,43.335557
1953,Family,4000000,87404651,83404651,16.861533
1953,Fantasy,4000000,87404651,83404651,16.861533
1953,Horror,2868000,30800000,27932000,18.105462
1953,Music,4000000,87404651,83404651,16.861533
1953,Mystery,658000,23800000,23142000,9.072006
1953,Romance,4955000,47405000,42450000,30.220458
1953,Science Fiction,2226000,8000000,5774000,9.925932
1953,Thriller,3250000,10500000,7250000,20.214863
1953,War,1650000,30500000,28850000,5.358582
1953,Western,3100000,20000000,16900000,6.63816
1954,Action,2000000,271841,-1728159,15.01777
1954,Adventure,5000000,28200000,23200000,8.722406
1954,Comedy,2238813,10000000,7761187,7.359741
1954,Crime,2310000,12600000,10290000,26.064324000000003
1954,Drama,22648813,124786154,102137341,86.909912
1954,History,5000000,15000000,10000000,10.374608
1954,Mystery,2400000,39764313,37364313,25.764545000000002
1954,Romance,6738813,13200000,6461187,7.672772999999999
1954,Science Fiction,5000000,28200000,23200000,8.722406
1954,Thriller,2400000,39764313,37364313,25.764545000000002
1954,War,2000000,21750000,19750000,8.999948
1955,Action,66000,250000,184000,1.114697
1955,Comedy,1200000,7000000,5800000,6.486117
1955,Crime,3837000,12788000,8951000,14.046319
1955,Drama,4180001,15788005,11608004,32.06423
1955,Mystery,3700000,15750000,12050000,11.976621999999999
1955,Romance,2843000,11750000,8907000,17.079586
1955,Thriller,3700000,15750000,12050000,11.976621999999999
1955,Western,1271000,3788000,2517000,7.441117
1956,Action,8300000,47250000,38950000,18.401832000000002
1956,Adventure,14900000,65900000,51000000,29.407784999999997
1956,Comedy,6000000,42000000,36000000,6.164226
1956,Crime,3700000,12250000,8550000,21.108573
1956,Drama,44070000,240910000,196840000,64.439156
1956,Family,6000000,42000000,36000000,6.164226
1956,Fantasy,6000000,42000000,36000000,6.164226
1956,History,13000000,122700000,109700000,11.14704
1956,Music,5550000,30300000,24750000,8.788305
1956,Mystery,3700000,12250000,8550000,21.108573
1956,Romance,17550000,84800000,67250000,18.618807999999998
1956,Science Fiction,1900000,3250000,1350000,6.379966
1956,Thriller,2500000,10250000,7750000,12.547763
1956,War,6000000,12500000,6500000,3.666277
1956,Western,6400000,44000000,37600000,12.021866
1957,Adventure,1750000,2200000,450000,4.250819
1957,Crime,3000000,9000000,6000000,9.730217
1957,Drama,8182000,41400000,33218000,40.09348099999999
1957,Fantasy,82000,2000000,1918000,0.75684
1957,History,3000000,27200000,24200000,8.851646
1957,Horror,82000,2000000,1918000,0.75684
1957,Mystery,3000000,9000000,6000000,9.730217
1957,Science Fiction,82000,2000000,1918000,0.75684
1957,War,3000000,27200000,24200000,8.851646
1958,Crime,829000,2247465,1418465,9.665347
1958,Drama,4529000,22817789,18288789,29.867562
1958,Horror,878000,8480000,7602000,12.805007
1958,Music,6000000,36800000,30800000,2.747118
1958,Mystery,2479000,28000000,25521000,18.20822
1958,Romance,11479000,82370324,70891324,32.750184
1958,Science Fiction,788000,3480000,2692000,11.967158
1958,Thriller,3398000,35247465,31849465,28.711416
1958,War,6000000,36800000,30800000,2.747118
1959,Action,15000000,146900000,131900000,14.319743
1959,Adventure,15000000,146900000,131900000,14.319743
1959,Animation,6000000,51000000,45000000,14.276169
1959,Comedy,2883848,25000000,22116152,11.845107
1959,Drama,23500000,171900000,148400000,19.533634000000003
1959,Family,6000000,51000000,45000000,14.276169
1959,Fantasy,6000000,51000000,45000000,14.276169
1959,History,20000000,159100000,139100000,16.059641
1959,Mystery,4000000,13275000,9275000,12.410427
1959,Romance,13883848,88200000,74316152,27.861174000000002
1959,Thriller,4000000,13275000,9275000,12.410427
1959,War,5000000,12200000,7200000,1.739898
1960,Action,28000000,89650000,61650000,23.668117
1960,Adventure,12000000,7900000,-4100000,4.73816
1960,Comedy,7051000,50100000,43049000,19.006778000000004
1960,Drama,34957948,165050000,130092052,80.777381
1960,History,28000000,89650000,61650000,23.668117
1960,Horror,1226948,33533957,32307009,47.537884000000005
1960,Romance,6151000,40100000,33949000,16.268510000000003
1960,Thriller,1226948,33533957,32307009,47.537884000000005
1960,War,4000000,21750000,17750000,7.819581
1960,Western,14000000,12805000,-1195000,15.388912000000001
1961,Action,16000000,41400000,25400000,20.786102999999997
1961,Adventure,11580000,251780014,240200014,27.263776
1961,Animation,4000000,215880014,211880014,15.727519
1961,Comedy,12560000,234480669,221920669,36.73220500000001
1961,Crime,6000000,43656822,37656822,8.389903
1961,Drama,34877000,140640829,105763829,71.34254
1961,Family,7000000,219880014,212880014,18.772018
1961,Fantasy,200000,2000000,1800000,4.392322
1961,History,3000000,10000000,7000000,9.697105
1961,Horror,200000,2000000,1800000,4.392322
1961,Music,6000000,43656822,37656822,8.389903
1961,Romance,8160000,22000655,13840655,21.686338999999997
1961,Science Fiction,1580000,7000000,5420000,3.013584
1961,War,6000000,28900000,22900000,8.522673
1961,Western,6000000,4300000,-1700000,6.945886
1962,Action,10950000,109700000,98750000,30.702534
1962,Adventure,49950000,193275385,143325385,43.964147
1962,Crime,2000000,13129846,11129846,14.284787
1962,Drama,51214000,161779748,110565748,71.50401799999999
1962,History,59000000,183775385,124775385,34.803469
1962,Horror,15000,3274,-11726,1.274228
1962,Mystery,80000000,96105910,16105910,7.991677
1962,Romance,2000000,9250000,7250000,9.551293
1962,Thriller,80950000,155705910,74755910,27.923282999999998
1962,War,25000000,120095385,95095385,21.66426
1962,Western,18200000,58000000,39800000,13.923548
1963,Action,30900000,158898765,127998765,33.302088
1963,Adventure,19086000,194843236,175757236,45.423471
1963,Animation,3000000,22182353,19182353,10.636458
1963,Comedy,17436000,119173863,101737863,30.418872999999998
1963,Crime,9400000,60000000,50600000,13.266545
1963,Drama,55515000,103272899,47757899,38.017503
1963,Family,3000000,22182353,19182353,10.636458
1963,Fantasy,350000,1499275,1149275,4.817514
1963,History,53115000,130344471,77229471,29.263708
1963,Horror,2874500,16902804,14028304,18.192387999999998
1963,Mystery,4000000,13474588,9474588,7.098731
1963,Romance,38801000,128674588,89873588,20.926052
1963,Thriller,10000000,104117824,94117824,34.019574
1963,War,4000000,11744471,7744471,14.384114
1963,Western,2500000,10000000,7500000,4.526285
1964,Action,11800000,139681062,127881062,29.805646
1964,Adventure,2500000,124881062,122381062,13.78884
1964,Comedy,8360000,124012667,115652667,30.638735999999998
1964,Crime,2255161,7182857,4927696,12.057281
1964,Drama,52355161,120243860,67888699,55.757282
1964,Family,23000000,174343458,151343458,27.609884
1964,Fantasy,6000000,102272727,96272727,15.11549
1964,History,22500000,12750000,-9750000,14.428609
1964,Music,17560000,84370399,66810399,18.21366
1964,Mystery,2135161,7000000,4864839,6.409094
1964,Romance,20120000,84253588,64133588,20.703035
1964,Thriller,10435161,138681062,128245901,24.610498
1964,War,30100000,28990272,-1109728,28.645152999999997
1964,Western,200000,14500000,14300000,12.429704
1965,Action,11100000,171145658,160045658,15.70926
1965,Adventure,23100000,196478991,173378991,20.182586999999998
1965,Comedy,17600000,55283333,37683333,9.664752
1965,Drama,40000000,420337982,380337982,23.980241
1965,Family,8200000,286214286,278014286,9.06773
1965,History,20000000,15473333,-4526667,3.961342
1965,Music,8200000,286214286,278014286,9.06773
1965,Romance,20000000,404864649,384864649,20.018898999999998
1965,Thriller,5500000,141195658,135695658,10.517835
1965,War,14800000,111873236,97073236,11.545435000000001
1965,Western,4400000,15014873,10614873,16.351278
1966,Action,15500000,32000000,16500000,19.913557
1966,Adventure,32115000,66562222,34447222,27.10335
1966,Crime,3500000,12000000,8500000,8.55931
1966,Drama,42700000,129570459,86870459,47.008605
1966,History,4700000,29271548,24571548,18.320061
1966,Horror,280379,364937,84558,8.913793
1966,Mystery,6500000,25000000,18500000,14.802558000000001
1966,Romance,27000000,54562222,27562222,14.56494
1966,Science Fiction,5115000,12000000,6885000,12.53841
1966,Thriller,6500000,25000000,18500000,14.802558000000001
1966,War,12800000,20921548,8121548,22.67642
1966,Western,5853000,12000000,6147000,23.859455999999998
1967,Action,35620000,249829505,214209505,54.017019999999995
1967,Adventure,48900000,413473117,364573117,66.04196200000001
1967,Animation,4000000,205843612,201843612,22.845448
1967,Comedy,37500000,109411385,71911385,27.157895999999997
1967,Crime,17500000,121505302,104005302,51.049122
1967,Drama,31720000,370117274,338397274,73.76184099999999
1967,Family,22000000,214843612,192843612,26.741767000000003
1967,Fantasy,18000000,9000000,-9000000,3.896319
1967,Horror,4000000,11000000,7000000,6.216637
1967,Music,23000000,59000000,36000000,6.370717
1967,Mystery,2000000,27379978,25379978,9.059617
1967,Romance,30500000,117666667,87166667,16.331775
1967,Thriller,18000000,153164765,135164765,30.988087999999998
1967,War,5400000,45300000,39900000,15.640007
1967,Western,5860000,12000000,6140000,8.019495
1968,Action,19000000,96696299,77696299,36.893115
1968,Adventure,24000000,123095426,99095426,52.368007000000006
1968,Comedy,14076000,58223306,44147306,5.962191
1968,Crime,6247000,42345439,36098439,9.795132
1968,Drama,69293000,251577140,182284140,78.268881
1968,Family,10000000,37402877,27402877,8.630078
1968,History,7700000,21000000,13300000,12.088407
1968,Horror,3314000,63395426,60081426,25.888756
1968,Music,38320000,103626183,65306183,13.867421
1968,Mystery,14447000,102139992,87692992,36.774581999999995
1968,Romance,30093000,73082538,42989538,11.849148999999999
1968,Science Fiction,26250000,105410092,79160092,57.109964
1968,Thriller,6247000,42345439,36098439,9.795132
1968,War,14700000,32000000,17300000,21.480387999999998
1968,Western,8255000,14741508,6486508,29.085601
1969,Action,30500000,119653271,89153271,25.763043
1969,Adventure,12744087,82613134,69869047,21.078688
1969,Comedy,54000000,114886877,60886877,21.408099
1969,Crime,10000000,104058889,94058889,7.2058040000000005
1969,Drama,43600000,234772720,191172720,36.053051999999994
1969,Family,24000000,33208099,9208099,8.407519
1969,History,6000000,102308889,96308889,6.714577
1969,Music,52000000,84886877,32886877,19.593769
1969,Mystery,4000000,6000000,2000000,5.757907
1969,Romance,36000000,54958099,18958099,9.436124000000001
1969,Thriller,10500000,87974493,77474493,15.114170999999999
1969,Western,32244087,134626308,102382221,29.085873000000003
1970,Action,64201946,138089442,73887496,20.913923
1970,Adventure,61485000,142482818,80997818,50.15570399999999
1970,Animation,4000000,55675257,51675257,9.834047
1970,Comedy,50306946,216886927,166579981,41.354245999999996
1970,Crime,10000000,1500000,-8500000,4.127728
1970,Documentary,600000,34505110,33905110,3.624542
1970,Drama,121381000,531320366,409939366,64.19891199999999
1970,Family,4000000,55675257,51675257,9.834047
1970,History,89085000,190664953,101579953,38.96935499999999
1970,Music,600000,34505110,33905110,3.624542
1970,Mystery,13000000,20499718,7499718,16.453675
1970,Romance,19200000,138900000,119700000,16.514087
1970,Science Fiction,3000000,18999718,15999718,12.325947
1970,Thriller,22090000,141989151,119899151,15.130689
1970,War,62985000,231059961,168074961,42.749531
1970,Western,18716946,36559552,17842606,10.724949
1971,Action,20950000,305091133,284141133,51.431492
1971,Adventure,31200000,146041165,114841165,26.103802
1971,Animation,20000000,17900000,-2100000,10.362012
1971,Comedy,22000000,29733696,7733696,14.693831
1971,Crime,12725000,103108169,90383169,33.140657999999995
1971,Drama,24552000,249311430,224759430,60.185016000000005
1971,Family,23000000,21900000,-1100000,22.778647
1971,Fantasy,23000000,21900000,-1100000,22.778647
1971,Music,20000000,17900000,-2100000,10.362012
1971,Mystery,2977000,5688794,2711794,14.784748
1971,Romance,9875000,109104330,99229330,16.483233000000002
1971,Science Fiction,11977000,53751468,41774468,48.466199
1971,Thriller,27725000,303770585,276045585,61.410834
1972,Action,18160254,255595115,237434861,48.289711999999994
1972,Adventure,14978000,148185473,133207473,22.768950999999998
1972,Comedy,2012000,24016290,22004290,11.117352
1972,Crime,15382254,417498508,402116254,74.84849700000001
1972,Drama,19260000,369432866,350172866,73.129344
1972,Horror,112000,28000000,27888000,7.261623999999999
1972,Mystery,5578000,44600000,39022000,7.599995
1972,Romance,1250000,36144000,34894000,12.74564
1972,Science Fiction,1700000,9700000,8000000,12.843375
1972,Thriller,8852254,117554352,108702098,23.830661
1972,Western,6000000,7500000,1500000,3.189566
1973,Action,12692000,264080431,251388431,41.536815
1973,Adventure,9142000,163235836,154093836,11.19849
1973,Animation,15950000,33556467,17606467,12.000766
1973,Comedy,9227000,319461056,310234056,28.075219999999998
1973,Crime,24992000,339141327,314149327,68.888101
1973,Drama,31727000,830489472,798762472,78.92271199999999
1973,Family,15000000,32056467,17056467,11.179855
1973,History,3000000,29800000,26800000,12.842165
1973,Horror,8000000,441306145,433306145,12.137595
1973,Mystery,2142000,1458000,-684000,1.424722
1973,Romance,2000000,18344729,16344729,6.048904
1973,Science Fiction,3700000,27189324,23489324,17.693668000000002
1973,Thriller,17992000,694541981,676549981,34.023842
1973,Western,10138783,26700000,16561217,15.692105999999999
1974,Action,34000000,362238653,328238653,47.70285200000001
1974,Adventure,10000000,144572000,134572000,20.607993
1974,Comedy,8300000,248781408,240481408,32.033421000000004
1974,Crime,29500000,159770916,130270916,89.103017
1974,Drama,46160000,316970769,270810769,111.335451
1974,Horror,85000,30859000,30774000,15.526413
1974,Mystery,7600000,34420000,26820000,25.537908
1974,Romance,6500000,26533200,20033200,5.702638
1974,Science Fiction,2800000,86273333,83473333,9.339316
1974,Thriller,40000000,392238653,352238653,59.99512200000001
1974,Western,2600000,119500000,116900000,13.233262
1975,Action,1370000,35800000,34430000,9.777912
1975,Adventure,8400000,491682948,483282948,32.461187
1975,Comedy,16035700,201442956,185407256,39.856496
1975,Crime,10340000,104299203,93959203,22.988521
1975,Drama,24535700,217113256,192577556,71.456075
1975,Family,65700,214600,148900,0.96053
1975,Fantasy,400000,5028948,4628948,10.43389
1975,History,3000000,20173742,17173742,5.165666
1975,Horror,8200000,583546319,575346319,28.425542
1975,Music,12200000,148643844,136443844,15.654318
1975,Mystery,7500000,43833347,36333347,10.377019
1975,Romance,17000000,21500000,4500000,14.622543
1975,Science Fiction,1500000,120892319,119392319,14.764326
1975,Thriller,12300000,535319856,523019856,33.433265
1975,War,11000000,20000000,9000000,14.003467
1976,Action,18780000,72736000,53956000,16.489072999999998
1976,Adventure,32000000,115614445,83614445,12.652989999999999
1976,Comedy,54564200,153688522,99124322,30.445056
1976,Crime,19245000,135777638,116532638,37.225367
1976,Drama,52745000,550356808,497611808,73.501863
1976,Family,35000000,35323292,323292,8.399441
1976,History,8500000,70600000,62100000,12.421754
1976,Horror,4600000,94722980,90122980,25.918968999999997
1976,Music,6000000,161000000,155000000,2.447359
1976,Mystery,14500000,104433201,89933201,18.008674
1976,Romance,21500000,237079064,215579064,17.543841999999998
1976,Science Fiction,9000000,25000000,16000000,6.842274
1976,Thriller,37100000,292247064,255147064,64.997653
1976,Western,3700000,31800000,28100000,5.849522
1977,Action,79000000,1053971338,974971338,87.402442
1977,Adventure,80700000,1113490403,1032790403,97.590989
1977,Animation,2400000,80215869,77815869,14.239158
1977,Comedy,7400000,69314463,61914463,23.247196
1977,Crime,5500000,26414658,20914658,6.389326
1977,Drama,67820000,709293756,641473756,82.14064399999998
1977,Family,4700000,87215869,82515869,14.827075
1977,Fantasy,19910000,133965011,114055011,33.879798
1977,History,22000000,50750000,28750000,7.719173
1977,Horror,21490000,97466996,75976996,30.013975
1977,Music,6900000,268176222,261276222,18.758357
1977,Mystery,810000,1258000,448000,3.099222
1977,Romance,4000000,38251425,34251425,18.146043
1977,Science Fiction,53960000,1139906642,1085946642,73.100776
1977,Thriller,63060000,288860473,225800473,51.848768
1977,War,22000000,50750000,28750000,7.719173
1978,Action,79800016,375031550,295231534,48.260144000000004
1978,Adventure,89000005,362682344,273682339,45.020092999999996
1978,Animation,5000000,34185188,29185188,13.516921
1978,Comedy,17215123,187765185,170550062,22.462515
1978,Crime,2300000,35000000,32700000,7.186048
1978,Drama,51915129,227194276,175279147,58.913380000000004
1978,Family,24000000,21049053,-2950947,4.233081
1978,Fantasy,83000000,351738491,268738491,27.607977999999996
1978,Horror,43750000,407448895,363698895,75.132586
1978,Music,24000000,21049053,-2950947,4.233081
1978,Mystery,18420000,58606617,40186617,20.087632
1978,Romance,8515123,205813874,197298751,17.866294
1978,Science Fiction,64000000,348264551,284264551,32.523772
1978,Thriller,49100000,377978895,328878895,63.202991999999995
1978,War,20000000,57230000,37230000,12.779914999999999
1979,Action,127400000,556543270,429143270,78.985823
1979,Adventure,105100000,583639682,478539682,62.805589999999995
1979,Comedy,62000000,134361708,72361708,36.838679
1979,Crime,12000000,65490039,53490039,23.294964999999998
1979,Drama,110550000,614563077,504013077,94.904398
1979,Family,22700000,73641544,50941544,17.74552
1979,History,17500000,23438120,5938120,11.157288
1979,Horror,23300000,170920270,147620270,33.565931
1979,Music,9250000,29174648,19924648,2.132964
1979,Mystery,35000000,139000000,104000000,8.277765
1979,Romance,27350000,53421768,26071768,20.455331
1979,Science Fiction,112700000,656070270,543370270,71.33197600000001
1979,Thriller,69300000,502463994,433163994,64.959155
1979,War,34000000,104475055,70475055,16.680726
1979,Western,9200000,9346177,146177,7.085212
1980,Action,176000000,923052236,747052236,64.463946
1980,Adventure,110500000,808131925,697631925,44.46118
1980,Comedy,81500000,352155222,270655222,62.083608999999996
1980,Crime,53000000,167359367,114359367,26.270397
1980,Drama,148000000,255217543,107217543,75.464843
1980,Fantasy,89000000,232784193,143784193,24.687467
1980,History,59000000,45290384,-13709616,16.356856
1980,Horror,43050000,191699464,148649464,64.595477
1980,Music,62000000,204884272,142884272,16.706725
1980,Mystery,36500000,83205253,46705253,24.468207000000003
1980,Romance,60500000,143843181,83343181,37.275158999999995
1980,Science Fiction,129500000,791685558,662185558,51.053881999999994
1980,Thriller,66300000,137074164,70774164,57.071212
1980,War,4500000,7206220,2706220,5.395103
1980,Western,54000000,19279520,-34720480,7.9511840000000005
1981,Action,145000000,888520203,743520203,90.32655999999999
1981,Adventure,169300000,916850673,747550673,106.131365
1981,Animation,12048740,30755401,18706661,10.742828
1981,Comedy,130600000,547668075,417068075,93.44217199999999
1981,Crime,15000000,26797457,11797457,7.531809
1981,Documentary,5000000,2028612,-2971388,0.303062
1981,Drama,191048740,533978893,342930153,108.261812
1981,Family,42048740,116368006,74319266,29.171070999999998
1981,Fantasy,49000000,132535359,83535359,29.529089
1981,History,54500000,196095563,141595563,28.590874
1981,Horror,47450000,152351239,104901239,76.148843
1981,Music,27000000,11199901,-15800099,8.334823
1981,Mystery,36750000,12755730,-23994270,16.346142
1981,Romance,71848740,177684631,105835891,37.344317999999994
1981,Science Fiction,33100000,148811584,115711584,48.648858
1981,Thriller,122100000,364016824,241916824,80.38076200000002
1981,War,17000000,96740000,79740000,16.24996
1981,Western,18000000,2945600,-15054400,1.38292
1982,Action,108000000,598945689,490945689,89.985761
1982,Adventure,96500000,1236883084,1140383084,80.890684
1982,Animation,7000000,14665733,7665733,10.812275
1982,Comedy,183550000,479711929,296161929,82.93689400000001
1982,Crime,14000000,123868508,109868508,23.262124
1982,Documentary,5000000,2091037,-2908963,1.629796
1982,Drama,187550000,653472557,465922557,212.42370499999996
1982,Family,84200000,900520961,816320961,56.753586
1982,Fantasy,64500000,987454325,922954325,68.17255699999998
1982,History,22000000,77737889,55737889,12.383755
1982,Horror,65500000,239627151,174127151,56.544470000000004
1982,Music,75200000,94474686,19274686,29.973278
1982,Mystery,17500000,34029760,16529760,22.897868000000003
1982,Romance,55700000,244384556,188684556,54.747217
1982,Science Fiction,109300000,1081122048,971822048,174.44075
1982,Thriller,115500000,505077010,389577010,161.30718000000002
1982,War,21000000,126530561,105530561,28.072453
1982,Western,3500000,20659423,17159423,3.382894
1983,Action,269350000,1270075504,1000725504,114.224345
1983,Adventure,201850000,1092964116,891114116,74.37474399999999
1983,Animation,4200000,21760883,17560883,20.214106
1983,Comedy,144950000,362985390,218035390,70.544601
1983,Crime,109520000,235933083,126413083,63.39363900000001
1983,Drama,153020000,405008088,251988088,92.61368700000001
1983,Family,3000000,21000000,18000000,11.742804
1983,Fantasy,96200000,128237973,32037973,37.756487
1983,History,27000000,21500000,-5500000,14.902397
1983,Horror,67397000,217692364,150295364,63.860389
1983,Music,38000000,188213873,150213873,17.341926
1983,Mystery,30377000,53106512,22729512,20.220243999999997
1983,Romance,74550000,345225906,270675906,54.078458000000005
1983,Science Fiction,164002000,852294854,688292854,98.845287
1983,Thriller,238945000,842926760,603981760,132.827768
1983,Western,5000000,12232628,7232628,5.839893
1984,Action,337600000,1266468160,928868160,161.55359099999998
1984,Adventure,248500000,788510683,540010683,123.609535
1984,Animation,1000000,3301446,2301446,11.267366
1984,Comedy,212000000,1301712414,1089712414,144.01346100000004
1984,Crime,123000000,548303927,425303927,56.382893
1984,Documentary,1200000,4978922,3778922,2.359569
1984,Drama,282346964,553166823,270819859,188.09734099999997
1984,Family,35200000,100194210,64994210,24.629911
1984,Fantasy,171800000,727732115,555932115,117.18373399999997
1984,History,77400000,123874435,46474435,59.716798
1984,Horror,53950000,309183021,255233021,82.74728200000001
1984,Music,109600000,244134543,134534543,65.079799
1984,Mystery,16000000,30623287,14623287,21.856156
1984,Romance,144900000,408506497,263606497,74.158686
1984,Science Fiction,197150000,338481403,141331403,92.639195
1984,Thriller,113500000,364677946,251177946,103.507641
1984,War,21900000,79334049,57434049,29.720810999999998
1985,Action,229115523,751307653,522192130,155.06089599999999
1985,Adventure,397115523,1263463360,866347837,194.928491
1985,Animation,40000000,24649492,-15350508,10.539499
1985,Comedy,255760000,937751412,681991412,176.938615
1985,Crime,68000000,178616515,110616515,44.408202
1985,Drama,278510000,829253628,550743628,146.76882100000003
1985,Family,153000000,490701916,337701916,63.941752
1985,Fantasy,177900000,96242214,-81657786,58.388044
1985,History,39500000,4428227,-35071773,15.056234
1985,Horror,25800000,137112282,111312282,56.337875
1985,Mystery,23000000,74256885,51256885,13.760494999999999
1985,Romance,139810000,284681679,144871679,59.960277000000005
1985,Science Fiction,165705523,502617941,336912418,84.299384
1985,Thriller,173100000,676898429,503798429,118.01734800000001
1985,War,74410000,311514453,237104453,23.840812
1986,Action,204900113,1022119467,817219354,175.773984
1986,Adventure,211500113,798854930,587354817,112.350882
1986,Animation,29000000,129017199,100017199,29.871649999999995
1986,Comedy,290300000,910348812,620048812,144.371592
1986,Crime,80400000,120802942,40402942,61.790099
1986,Drama,204900113,744544278,539644165,170.763574
1986,Family,75000113,289306711,214306598,58.255390000000006
1986,Fantasy,126600000,115687347,-10912653,76.961418
1986,History,24500000,17218023,-7281977,11.241995
1986,Horror,150400000,410853919,260453919,125.543218
1986,Music,29000000,41574918,12574918,13.090761
1986,Mystery,41000000,110107948,69107948,31.054924000000003
1986,Romance,87700113,601888038,514187925,72.75982099999999
1986,Science Fiction,168700000,450634206,281934206,99.68171299999999
1986,Thriller,116000000,377278893,261278893,85.62762999999998
1986,War,36000000,538085183,502085183,45.898003
1987,Action,317000000,980840383,663840383,139.99949900000001
1987,Adventure,221200000,548940588,327740588,93.730821
1987,Animation,8000000,3261638,-4738362,0.743274
1987,Comedy,304830006,1173862316,869032310,197.579362
1987,Crime,158000001,732316691,574316690,88.426073
1987,Drama,304800001,1146950102,842150101,197.33573700000002
1987,Family,36000000,91552667,55552667,36.266434
1987,Fantasy,69300000,106108414,36808414,63.292761999999996
1987,History,88800000,142750423,53950423,34.159391
1987,Horror,68950000,468340990,399390990,92.631022
1987,Music,12500000,268169690,255669690,20.520656
1987,Mystery,43200000,340489575,297289575,28.062407
1987,Romance,138180007,804769215,666589208,123.27747500000001
1987,Science Fiction,141700000,267897496,126197496,75.497929
1987,Thriller,235000000,1038319957,803319957,134.881447
1987,War,65000000,192518742,127518742,33.185668
1987,Western,5800000,257043,-5542957,1.799311
1988,Action,294514000,611419101,316905101,147.26272500000002
1988,Adventure,219430000,464666238,245236238,80.813659
1988,Animation,130300000,490933574,360633574,52.150384
1988,Comedy,516414000,1772506560,1256092560,255.64281599999995
1988,Crime,264800000,774136732,509336732,160.946101
1988,Documentary,2500000,589244,-1910756,2.726061
1988,Drama,353500000,1266305550,912805550,223.95869
1988,Family,159300000,696254500,536954500,67.12357499999999
1988,Fantasy,158130000,570837976,412707976,59.648649000000006
1988,History,16000000,4192440,-11807560,2.549325
1988,Horror,126710000,274883229,148173229,182.76467699999995
1988,Music,12500000,4505547,-7994453,14.235738
1988,Mystery,48000000,29474437,-18525563,21.458487
1988,Romance,192884000,890421676,697537676,90.26297400000001
1988,Science Fiction,109210000,113308384,4098384,106.758082
1988,Thriller,267600000,693470570,425870570,215.12441400000003
1988,War,79000000,193208051,114208051,14.174191
1988,Western,13000000,44726644,31726644,9.905174
1989,Action,428000000,1742044534,1314044534,138.61566200000001
1989,Adventure,438900000,1766424260,1327524260,154.57129100000003
1989,Animation,60700000,267572876,206872876,36.785802000000004
1989,Comedy,483345760,2284309509,1800963749,236.747558
1989,Crime,203545760,647690168,444144408,107.36856
1989,Documentary,160000,6706368,6546368,4.877009
1989,Drama,374245180,1269672004,895426824,206.529141
1989,Family,158800000,906609089,747809089,70.78389899999999
1989,Fantasy,130700000,746945103,616245103,66.51000499999999
1989,History,22660000,25377685,2717685,12.312697
1989,Horror,87500000,181966393,94466393,67.823733
1989,Mystery,27045760,146030473,118984713,20.159191
1989,Romance,114500000,501662215,387162215,58.051897
1989,Science Fiction,210500000,782425786,571925786,92.42123500000001
1989,Thriller,318500000,798545149,480045149,140.92646100000002
1989,War,70500000,208922297,138422297,30.203904
1990,Action,471000000,1560178963,1089178963,183.21971699999997
1990,Adventure,407431000,1704385196,1296954196,115.089754
1990,Animation,37931000,47431461,9500461,1.562471
1990,Comedy,469000000,2152799825,1683799825,135.157713
1990,Crime,399931000,932499112,532568112,145.75525900000002
1990,Documentary,500000,3779620,3279620,4.101295
1990,Drama,630000000,2085231416,1455231416,247.290188
1990,Family,144431000,1002296959,857865959,37.580871
1990,Fantasy,196431000,703763515,507332515,68.68137
1990,Horror,206200000,346673083,140473083,118.37137299999998
1990,Music,11000000,8266343,-2733657,8.290384
1990,Mystery,142500000,805130362,662630362,51.326072
1990,Romance,205000000,1105090482,900090482,81.40918500000001
1990,Science Fiction,269700000,969386905,699686905,115.304533
1990,Thriller,543200000,2045516321,1502316321,236.78229400000004
1990,Western,22000000,424208848,402208848,11.654349
1991,Action,688000000,1656877824,968877824,221.367376
1991,Adventure,391000000,1216811734,825811734,117.163297
1991,Animation,43000000,389007938,346007938,27.035542
1991,Comedy,631316000,1474674928,843358928,216.37109200000006
1991,Crime,333010000,1277840856,944830856,124.933212
1991,Documentary,4,29,25,1.325299
1991,Drama,596677401,1690338050,1093660649,228.68525799999995
1991,Family,279788000,945927863,666139863,98.99043499999999
1991,Fantasy,229788000,922788681,693000681,92.79726199999999
1991,History,40000000,205405498,165405498,13.813146
1991,Horror,54250000,247544238,193294238,50.96288
1991,Music,127200004,448120366,320920362,48.981132
1991,Mystery,115237401,190098986,74861585,27.129727000000003
1991,Romance,202018000,528248463,326230463,53.073996
1991,Science Fiction,261250000,779993629,518743629,78.48967400000001
1991,Thriller,612500000,2050581959,1438081959,236.370547
1991,War,26000000,181096164,155096164,11.026793
1991,Western,27000000,179033791,152033791,7.334686
1992,Action,523120007,1763765841,1240645834,191.821658
1992,Adventure,307000000,1530500724,1223500724,110.97632
1992,Animation,58000000,518160808,460160808,28.139314
1992,Comedy,592400030,2213089460,1620689430,215.89278299999998
1992,Crime,195525545,1118691657,923166112,116.42013399999999
1992,Drama,608985541,1624520318,1015534777,217.422851
1992,Family,120000000,994974786,874974786,53.532299
1992,Fantasy,258000000,972277892,714277892,73.942721
1992,History,121000000,130867163,9867163,41.054587
1992,Horror,141000007,517194102,376194095,97.363057
1992,Music,76000000,764309213,688309213,38.816443
1992,Mystery,122500000,404517421,282017421,41.131676999999996
1992,Romance,246835571,1535132701,1288297130,99.63501999999998
1992,Science Fiction,148000007,271634176,123634169,51.462261999999996
1992,Thriller,334725545,1911698520,1576972975,198.733547
1992,War,45000000,88040817,43040817,21.775345
1992,Western,74000000,296941287,222941287,18.414902
1993,Action,606600000,1618355668,1011755668,200.365785
1993,Adventure,517600000,2146490125,1628890125,125.216313
1993,Animation,37000000,87833852,50833852,28.166243
1993,Comedy,575500000,1720500099,1145000099,223.64969399999998
1993,Crime,420000000,1275822794,855822794,156.664805
1993,Drama,842685552,3184272968,2341587416,345.43092299999995
1993,Family,333000000,1160181164,827181164,98.166286
1993,Fantasy,236600000,404328108,167728108,76.522135
1993,History,117000000,401364391,284364391,63.398301000000004
1993,Horror,78685552,121479653,42794101,75.45137700000001
1993,Music,57000000,59439023,2439023,14.405062999999998
1993,Mystery,219385552,1053010433,833624881,69.58361799999999
1993,Romance,211900000,565488844,353588844,122.37272
1993,Science Fiction,190000000,1147066638,957066638,59.836761
1993,Thriller,597285552,1867238444,1269952892,222.23735299999996
1993,War,47000000,455118392,408118392,55.207494000000004
1993,Western,60000000,75140685,15140685,15.991655999999999
1994,Action,863600000,2166153858,1302553858,207.05627399999997
1994,Adventure,314400000,1018227120,703827120,104.95779
1994,Animation,158000000,823128991,665128991,55.420512
1994,Comedy,659907000,2633974507,1974067507,267.730054
1994,Crime,411400000,1718954354,1307554354,338.49468899999994
1994,Documentary,700000,7830611,7130611,9.47666
1994,Drama,808300000,3160687358,2352387358,351.8363880000001
1994,Family,345580000,1427167555,1081587555,95.274609
1994,Fantasy,254000000,1108166280,854166280,113.56982
1994,History,18000000,5887457,-12112543,11.720358
1994,Horror,142600000,372974893,230374893,60.16841000000001
1994,Mystery,207000000,488791201,281791201,73.945402
1994,Romance,499000000,2192754884,1693754884,168.113847
1994,Science Fiction,289500000,646506939,357006939,85.331244
1994,Thriller,815000000,2132247593,1317247593,383.026809
1994,War,70000000,184971207,114971207,17.184204
1994,Western,63000000,25052000,-37948000,9.277147
1995,Action,1443000050,3300029325,1857029275,328.18997499999995
1995,Adventure,826000000,1964456771,1138456771,160.40279600000002
1995,Animation,113000000,723617718,610617718,37.531998
1995,Comedy,598600006,2153144003,1554543997,299.686553
1995,Crime,621419413,1778845533,1157426120,221.95903399999995
1995,Drama,1258769413,3466538741,2207769328,448.41552099999996
1995,Family,301500000,1653297034,1351797034,101.716745
1995,Fantasy,341000008,1356673053,1015673045,113.509175
1995,Foreign,2,1,-1,2.466066
1995,History,166000000,234064172,68064172,32.599267999999995
1995,Horror,80000008,166072638,86072630,57.138801
1995,Mystery,236500000,797865875,561365875,71.943692
1995,Romance,498500006,1140977199,642477193,200.73586999999998
1995,Science Fiction,429500000,866257247,436757247,120.24689000000001
1995,Thriller,988819423,2724620943,1735801520,329.81424699999997
1995,War,107000000,225000000,118000000,22.445916999999998
1995,Western,32000000,18552460,-13447540,7.54701
1996,Action,1238800000,3755642955,2516842955,256.398321
1996,Adventure,871530012,3044560393,2173030381,186.48405899999997
1996,Animation,218000000,379260115,161260115,37.825873
1996,Comedy,913500012,2044262130,1130762118,254.0976349999999
1996,Crime,443100000,1032300789,589200789,168.535046
1996,Drama,1659662063,3763797047,2104134984,466.816253
1996,Family,448530012,933456976,484926964,80.31615
1996,Fantasy,450000012,926130293,476130281,122.811797
1996,History,60962051,148167469,87205418,18.632129
1996,Horror,191000000,338394142,147394142,90.583038
1996,Music,68000000,145666193,77666193,16.200661
1996,Mystery,340000000,754220741,414220741,84.419248
1996,Romance,390200000,1138737508,748537508,161.577515
1996,Science Fiction,561000000,1682312312,1121312312,129.10852200000002
1996,TV Movie,5000000,42000000,37000000,5.147819
1996,Thriller,1435600000,3231343823,1795743823,354.33590799999996
1996,War,73000000,332837243,259837243,27.159477000000003
1997,Action,1950716953,3907835003,1957118050,314.85359900000003
1997,Adventure,1449637731,3126796605,1677158874,227.86954000000006
1997,Animation,196500000,555458394,358958394,46.533428
1997,Comedy,880733628,3493951527,2613217899,297.44036200000005
1997,Crime,937866953,1781362865,843495912,209.63253600000002
1997,Drama,1576417125,4341636025,2765218900,430.9289700000001
1997,Family,361317731,827707901,466390170,78.387897
1997,Fantasy,490637731,1207106839,716469108,121.56663699999999
1997,History,136000000,218588031,82588031,16.646886
1997,Horror,431020000,966210365,535190365,121.715102
1997,Music,57000000,103566637,46566637,7.664352
1997,Mystery,665270000,1252118494,586848494,174.478199
1997,Romance,618550450,2953636310,2335085860,140.21164800000003
1997,Science Fiction,954750000,2344711522,1389961522,188.999156
1997,Thriller,2343170000,5487572989,3144402989,452.480673
1998,Action,1442537300,3251710633,1809173333,254.50007599999998
1998,Adventure,1248500000,2824630189,1576130189,203.34628800000002
1998,Animation,464000250,1364821358,900821108,99.863781
1998,Comedy,1404437550,3708288294,2303850744,403.57565600000004
1998,Crime,779866000,1563875037,784009037,196.08167799999998
1998,Documentary,891000,229000,-662000,0.179246
1998,Drama,1701560804,3674596473,1973035669,452.5578700000001
1998,Family,695000000,1719177796,1024177796,121.810648
1998,Fantasy,552000000,974237146,422237146,89.751154
1998,Foreign,1070000,570000,-500000,0.170074
1998,History,177000000,951435910,774435910,52.921496000000005
1998,Horror,338300000,484048880,145748880,114.236969
1998,Music,130070000,259487143,129417143,41.693138999999995
1998,Mystery,484060000,657408648,173348648,122.674097
1998,Romance,734800000,2273140804,1538340804,205.202277
1998,Science Fiction,815000000,1574006111,759006111,144.043112
1998,Thriller,1391803300,3066918482,1675115182,269.095562
1998,War,197010000,594685357,397675357,40.244935
1999,Action,1592000000,3372006222,1780006222,258.69238099999995
1999,Adventure,1185000000,3150845353,1965845353,174.69574699999995
1999,Animation,578000000,1505485381,927485381,77.795986
1999,Comedy,2019534302,4384523059,2364988757,465.199779
1999,Crime,811000000,2041632820,1230632820,189.70788499999998
1999,Documentary,2053648,500000,-1553648,2.691433
1999,Drama,2223984326,5357232183,3133247857,554.9826690000002
1999,Family,732000000,1708354519,976354519,126.123787
1999,Fantasy,948000000,1829778503,881778503,160.997533
1999,Foreign,7400005,22000135,14600130,0.238346
1999,History,60000000,66976317,6976317,9.471838
1999,Horror,468060000,847508783,379448783,129.90767200000002
1999,Music,86500000,95091685,8591685,21.047405
1999,Mystery,902060000,2578886717,1676826717,191.48089499999998
1999,Romance,812050001,2110027593,1297977592,203.93311500000007
1999,Science Fiction,1150000000,2607273982,1457273982,246.46747500000004
1999,Thriller,1394400000,2791772105,1397372105,302.557404
1999,War,110000000,88612976,-21387024,19.626039
1999,Western,208000000,222739777,14739777,16.94691
2000,Action,1728100000,3970220079,2242120079,302.02869099999987
2000,Adventure,1342500030,3647844621,2305344591,261.15593799999994
2000,Animation,580500030,1079109681,498609651,91.61853599999998
2000,Comedy,1799300030,4477587317,2678287287,388.6991090000001
2000,Crime,692020000,1823177767,1131157767,204.63621099999997
2000,Drama,1886870006,4342396382,2455526376,540.8878939999998
2000,Family,958500030,1750587118,792087088,141.44741
2000,Fantasy,592000000,1005171069,413171069,96.53359799999998
2000,Foreign,5400000,6023791,623791,1.477313
2000,History,170000000,286294342,116294342,26.239062
2000,Horror,368120000,595018115,226898115,102.79908900000001
2000,Music,183800000,375959054,192159054,72.464881
2000,Mystery,230000000,389936069,159936069,69.53408
2000,Romance,723500006,1913989566,1190489560,203.95246799999998
2000,Science Fiction,1020000000,1437332695,417332695,126.665439
2000,Thriller,1576970000,3383445424,1806475424,351.379064
2000,War,276000000,435360757,159360757,39.395911999999996
2000,Western,55000000,56932305,1932305,10.308442
2001,Action,2450697415,5133646031,2682948616,414.28576099999987
2001,Adventure,1561050000,5203635978,3642585978,314.2804540000001
2001,Animation,646500000,1833528976,1187028976,142.68374599999999
2001,Comedy,1818357759,4644284831,2825927072,438.692267
2001,Crime,1285500028,2681323374,1395823346,256.035347
2001,Documentary,36166397,22291080,-13875317,3.802972
2001,Drama,1634929000,3171148524,1536219524,470.542201
2001,Family,779000000,3319473693,2540473693,194.87328300000001
2001,Fantasy,835500000,3687498687,2851998687,228.66792100000004
2001,Foreign,500000,500000,0,0.233572
2001,History,333000000,755099395,422099395,43.944076
2001,Horror,231000000,601496520,370496520,80.13525100000001
2001,Music,127700000,295343612,167643612,33.536602
2001,Mystery,413000000,691261228,278261228,164.530598
2001,Romance,1333829344,3418131692,2084302348,303.83511799999997
2001,Science Fiction,908000000,1947610978,1039610978,144.593185
2001,Thriller,2046997415,4267652016,2220654601,393.78593000000006
2001,War,340000000,810940068,470940068,43.374272000000005
2001,Western,35000000,13678913,-21321087,10.855383
2002,Action,2487500000,6539061442,4051561442,475.79032299999994
2002,Adventure,1969000000,6030123677,4061123677,350.5301999999999
2002,Animation,509000000,1052401449,543401449,91.724031
2002,Comedy,1816650159,4514942237,2698292078,401.51080900000005
2002,Crime,1070300000,2506608458,1436308458,266.18198099999995
2002,Documentary,12040000,101294529,89254529,30.988756000000002
2002,Drama,2318969631,5395791666,3076822035,690.9440759999998
2002,Family,866000000,2549444251,1683444251,178.81072
2002,Fantasy,808934000,3490132645,2681198645,180.278218
2002,Foreign,4000000,6057862,2057862,2.342997
2002,History,424000000,604624951,180624951,52.210231
2002,Horror,385750000,1077331004,691581004,126.571892
2002,Music,82500000,425577417,343077417,28.947546
2002,Mystery,726000000,1906804744,1180804744,157.93778899999995
2002,Romance,791385631,1947907159,1156521528,292.20427699999993
2002,Science Fiction,1049000000,2780029285,1731029285,181.84210800000002
2002,Thriller,2220500000,4339026403,2118526403,500.988317
2002,War,331300000,375340315,44040315,54.94668
2002,Western,80000000,122563539,42563539,16.724836
2003,Action,2808456270,7712722417,4904266147,512.21281
2003,Adventure,1895000000,5446988849,3551988849,273.38461900000004
2003,Animation,262000000,1172296376,910296376,66.514766
2003,Comedy,1933411898,5226655557,3293243659,401.2643110000001
2003,Crime,959400000,2001235834,1041835834,264.08227899999997
2003,Documentary,13300218,26011409,12711191,8.864931
2003,Drama,1618850219,3066334394,1447484175,449.266873
2003,Family,617000000,2169509562,1552509562,131.670122
2003,Fantasy,914000000,3481275461,2567275461,197.66049999999998
2003,Foreign,2000000,33700,-1966300,1.188935
2003,History,309000000,625059004,316059004,40.971837
2003,Horror,253600000,694228817,440628817,110.51195700000001
2003,Music,74300000,250727059,176427059,39.083578
2003,Mystery,341000000,692724176,351724176,115.267562
2003,Romance,523911899,1378570403,854658504,150.04549299999996
2003,Science Fiction,1209000000,3097246123,1888246123,137.59589
2003,Thriller,2266800001,4787549905,2520749904,427.254254
2003,War,276000000,555341175,279341175,36.096306999999996
2003,Western,72000000,156619780,84619780,24.002355
2004,Action,2675250000,6113497470,3438247470,508.34337500000015
2004,Adventure,2629500000,7025478984,4395978984,380.3128710000001
2004,Animation,762000000,2987329662,2225329662,144.04733199999998
2004,Comedy,2404332258,5633474065,3229141807,619.1924910000002
2004,Crime,935950000,1894691736,958741736,260.972922
2004,Documentary,3015000,35256139,32241139,10.432422
2004,Drama,2312695800,5438217134,3125521334,656.4109570000003
2004,Family,1200500000,3958568057,2758068057,195.73360300000002
2004,Fantasy,1009200000,3698060840,2688860840,200.018217
2004,History,483839750,591312628,107472878,60.80522
2004,Horror,509300000,1307863884,798563884,172.06905600000002
2004,Music,196000000,358365934,162365934,66.318928
2004,Mystery,607050000,1443302107,836252107,141.669884
2004,Romance,1178200000,2466654154,1288454154,308.833226
2004,Science Fiction,993007000,2172770258,1179763258,217.03210800000005
2004,Thriller,1729687000,4155599242,2425912242,442.2095260000001
2004,War,630839750,1024276772,393437022,67.943496
2004,Western,245000000,133923411,-111076589,20.38161
2005,Action,2403949000,4657692986,2253743986,448.4920910000001
2005,Adventure,2339000000,6245698022,3906698022,379.963687
2005,Animation,420000000,1487990116,1067990116,90.592628
2005,Comedy,2480173714,5654074816,3173901102,535.2002219999999
2005,Crime,948949000,1779454893,830505893,286.50299
2005,Documentary,13300000,141514666,128214666,16.433495
2005,Drama,2891952393,6177482166,3285529773,794.170293
2005,Family,1524750000,4649731072,3124981072,294.89512
2005,Fantasy,1229000000,3483307958,2254307958,224.94789199999997
2005,Foreign,4323152,10233082,5909930,2.051602
2005,History,523500008,784030046,260530038,95.08820399999999
2005,Horror,640050000,1637782332,997732332,225.985466
2005,Music,138000000,371120029,233120029,39.372716
2005,Mystery,564975000,971678564,406703564,157.927098
2005,Romance,1156354206,2896271526,1739917320,291.91604000000007
2005,Science Fiction,911500000,2532063855,1620563855,149.319151
2005,Thriller,1799649000,4001342803,2201693803,483.53031000000004
2005,War,313500008,393988626,80488618,62.93654900000001
2005,Western,17000000,17084842,84842,18.505146
2006,Action,2710100003,6344691507,3634591504,445.1406159999999
2006,Adventure,2764300000,6931717484,4167417484,399.4031849999999
2006,Animation,1106200000,2714768826,1608568826,188.98056499999998
2006,Comedy,2426528878,6467633876,4041104998,634.641377
2006,Crime,1036125000,2088036984,1051911984,274.668278
2006,Documentary,15000000,120867586,105867586,27.199510999999998
2006,Drama,2962352208,5706915924,2744563716,883.1648470000002
2006,Family,1564000000,3737401739,2173401739,274.19752700000004
2006,Fantasy,1591700000,3912032922,2320332922,329.1353589999999
2006,Foreign,1333333,5333333,4000000,0.654216
2006,History,374000000,489167863,115167863,75.228843
2006,Horror,356200000,1038880126,682680126,163.32903200000004
2006,Music,64000000,162342508,98342508,27.564079
2006,Mystery,614165000,1469343498,855178498,162.57499399999998
2006,Romance,915883208,2081407540,1165524332,306.30454
2006,Science Fiction,940700000,1516432976,575732976,176.09167200000002
2006,Thriller,2764365000,5990813136,3226448136,595.401904
2006,War,337000000,743379960,406379960,110.371163
2006,Western,53000000,11692624,-41307376,24.329417
2007,Action,2550852313,6638255962,4087403649,424.50381300000004
2007,Adventure,2139802313,6693974932,4554172619,276.5393490000001
2007,Animation,938000000,3214534452,2276534452,119.565642
2007,Comedy,2452602313,6752404959,4299802646,521.8758460000001
2007,Crime,1313295000,2368032651,1054737651,361.521099
2007,Documentary,42000000,157975639,115975639,31.373903
2007,Drama,2328180151,5418826221,3090646070,747.4072450000001
2007,Family,1586000000,5393011987,3807011987,216.021449
2007,Fantasy,2105000000,6364204123,4259204123,245.19101400000005
2007,Foreign,34002313,13422222,-20580091,3.391818
2007,History,227200000,362033418,134833418,51.012145000000004
2007,Horror,768895000,2167764623,1398869623,299.25867400000016
2007,Music,323160000,957126219,633966219,87.150507
2007,Mystery,920810000,2917998970,1997188970,230.41971100000006
2007,Romance,793062500,2140820170,1347757670,244.48586899999998
2007,Science Fiction,710650000,1795624336,1084974336,125.38902300000001
2007,Thriller,2488375000,5217940543,2729565543,616.7473359999998
2007,War,77200000,40808453,-36391547,16.644979
2007,Western,88800000,87453271,-1346729,37.430289
2008,Action,3001863378,7860313118,4858449740,681.4223680000001
2008,Adventure,2755668200,6913779489,4158111289,487.322174
2008,Animation,872677699,2780871611,1908193912,129.173113
2008,Comedy,2474066429,6485919447,4011853018,597.948969
2008,Crime,1029030000,2875806720,1846776720,351.39490900000004
2008,Documentary,4900000,7705312,2805312,1.9013489999999997
2008,Drama,2679604407,6722586510,4042982103,951.9190959999999
2008,Family,1846928099,4491017710,2644089611,244.24836699999994
2008,Fantasy,1696250400,4088144304,2391893904,249.875452
2008,Foreign,19930000,17010000,-2920000,2.951917
2008,History,199792378,409885105,210092727,73.44015900000001
2008,Horror,127050000,401969398,274919398,86.626662
2008,Music,47200000,192553530,145353530,39.057622
2008,Mystery,518100000,1040001546,521901546,144.443308
2008,Romance,1261656800,4103146434,2841489634,383.16426199999995
2008,Science Fiction,1325200000,2463859102,1138659102,269.88765500000005
2008,Thriller,2047400000,5378062444,3330662444,593.6111159999997
2008,War,270500000,391610759,121110759,92.155829
2008,Western,20000000,20211394,211394,12.392754
2009,Action,2808804086,6710918136,3902114050,492.55604800000015
2009,Adventure,2862141880,8757020894,5894879014,409.51368699999995
2009,Animation,1185590235,3651961565,2466371330,174.07957000000005
2009,Comedy,2438799100,6941526578,4502727478,634.7743719999996
2009,Crime,927653567,2020904663,1093251096,283.6487369999999
2009,Documentary,20700000,18616185,-2083815,6.745010000000001
2009,Drama,2465274514,5603797238,3138522724,797.1706350000001
2009,Family,1909500000,5767159178,3857659178,264.877603
2009,Fantasy,1240057619,3561225022,2321167403,232.89064800000003
2009,Foreign,11289367,12981789,1692422,3.987239
2009,History,365000000,545520454,180520454,68.19736400000001
2009,Horror,363315739,1178699805,815384066,214.27751
2009,Music,322000000,964229990,642229990,53.6232
2009,Mystery,807906840,2175336597,1367429757,269.69510499999996
2009,Romance,1095284438,3325737195,2230452757,331.519106
2009,Science Fiction,2205000000,4848715607,2643715607,337.29336299999994
2009,Thriller,2107622654,4345898164,2238275510,561.255802
2009,War,214000000,576390480,362390480,48.098884000000005
2010,Action,3437486809,7527417062,4089930253,573.774827
2010,Adventure,3373500000,10168784372,6795284372,481.7651130000001
2010,Animation,1252100000,4330286832,3078186832,146.978151
2010,Comedy,3083450314,7521547348,4438097034,689.4911979999999
2010,Crime,922917686,1431304607,508386921,297.193364
2010,Documentary,26780000,128457046,101677046,31.936813
2010,Drama,2473265248,6349454563,3876189315,862.6087589999998
2010,Family,2452635000,8071733706,5619098706,273.855031
2010,Fantasy,2156000000,6379312963,4223312963,270.694837
2010,Foreign,3750000,5000000,1250000,0.597058
2010,History,122381809,540959065,418577256,39.930527
2010,Horror,351950000,1311883283,959933283,217.90888500000003
2010,Music,16400000,8895811,-7504189,21.24345
2010,Mystery,693787650,1938252805,1244465155,191.851698
2010,Romance,1356399000,3613922995,2257523995,336.93287199999986
2010,Science Fiction,1006150000,2996009013,1989859013,178.69185500000003
2010,Thriller,1930337650,4550278946,2619941296,529.0533340000001
2010,War,152200000,255443397,103243397,37.33957000000001
2010,Western,127000000,273903496,146903496,25.724376000000003
2011,Action,3668094609,9435792433,5767697824,638.513497
2011,Adventure,3338000000,10011289776,6673289776,390.102207
2011,Animation,1329000000,3825337077,2496337077,134.92516200000003
2011,Comedy,2855075528,7989251555,5134176027,694.6937179999996
2011,Crime,971536948,2277354003,1305817055,230.35017899999994
2011,Documentary,27263148,131980879,104717731,32.992795
2011,Drama,2490971241,5415874991,2924903750,852.6411510000001
2011,Family,1869000000,6055394893,4186394893,255.21969700000005
2011,Fantasy,1525000000,5503827639,3978827639,240.38507200000004
2011,Foreign,17612361,23108651,5496290,5.275261
2011,History,210134005,360709829,150575824,49.82150399999999
2011,Horror,410250596,944103422,533852826,193.217606
2011,Music,176920000,708188192,531268192,41.546992
2011,Mystery,751000000,2074288694,1323288694,202.43920399999996
2011,Romance,934405244,2943040304,2008635060,296.166014
2011,Science Fiction,1686050531,4810254291,3124203760,296.40764500000006
2011,Thriller,2470203183,5737684257,3267481074,649.1792750000004
2011,War,249100000,279064989,29964989,36.575597
2011,Western,298000000,420546928,122546928,21.540594
2012,Action,3741427500,11257048180,7515620680,629.2243429999997
2012,Adventure,3315500000,11544764553,8229264553,476.7228339999999
2012,Animation,1144016654,3952878155,2808861501,153.860801
2012,Comedy,2434275220,7254462138,4820186918,604.9487489999997
2012,Crime,872727500,2583136223,1710408723,248.24717300000003
2012,Documentary,16225000,67528019,51303019,17.107509
2012,Drama,2498730416,7720912890,5222182474,744.2383110000001
2012,Family,1248016654,4210547121,2962530467,172.56148299999995
2012,Fantasy,1762800000,6203564119,4440764119,263.415436
2012,Foreign,7225000,16111300,8886300,1.2614640000000001
2012,History,198000000,475702372,277702372,42.207029000000006
2012,Horror,347740000,1235755814,888015814,167.52891599999998
2012,Music,212000000,814413980,602413980,56.182613
2012,Mystery,247620000,594846296,347226296,65.44234099999998
2012,Romance,789617508,2976193794,2186576286,295.7531860000001
2012,Science Fiction,1853240000,5297439071,3444199071,343.00869400000005
2012,Thriller,2131671180,6168635191,4036964011,578.882824
2012,War,167000000,183705551,16705551,43.893024
2012,Western,100000000,425368238,325368238,19.785025
2013,Action,4326212753,10823594508,6497381755,686.074773
2013,Adventure,3641700000,10684968620,7043268620,501.0524980000001
2013,Animation,1445000000,5510573754,4065573754,223.40793100000002
2013,Comedy,1912540806,6696704285,4784163479,582.59255
2013,Crime,1367022753,3473770115,2106747362,409.35624299999984
2013,Drama,2770151571,6314887804,3544736233,1002.7910279999998
2013,Family,1856700000,6200953909,4344253909,230.20176500000005
2013,Fantasy,2229489000,5547230197,3317741197,241.57863500000002
2013,History,175460000,587328122,411868122,125.294181
2013,Horror,428900010,1832647813,1403747803,223.843316
2013,Music,149610015,146913362,-2696653,55.046531
2013,Mystery,268500000,436407076,167907076,74.97688799999999
2013,Romance,573770010,1318059332,744289322,254.36695399999994
2013,Science Fiction,2214800000,7214898416,5000098416,383.0551950000001
2013,Thriller,2123366383,5608007300,3484640917,567.3483080000001
2013,War,70000000,217425119,147425119,11.450698
2013,Western,262000000,89296057,-172703943,18.528965
2014,Action,4263172437,14634266434,10371093997,1317.0709160000001
2014,Adventure,3772500000,13076353741,9303853741,883.9241349999998
2014,Animation,948500000,3322117288,2373617288,326.519659
2014,Comedy,2024780479,7115551368,5090770889,822.3399419999998
2014,Crime,579800000,1114296473,534496473,277.60600199999993
2014,Drama,2553496144,6660306272,4106810128,1244.203227
2014,Family,1506400000,5098017045,3591617045,423.0927040000001
2014,Fantasy,1824500000,6019675077,4195175077,287.261111
2014,History,234722083,573658450,338936367,62.85708399999999
2014,Horror,207968000,995832508,787864508,207.09416800000002
2014,Music,135000000,366415031,231415031,24.616783
2014,Mystery,423250000,1202715626,779465626,352.012734
2014,Romance,818176288,2194148607,1375972319,256.27208100000007
2014,Science Fiction,2207953912,8233814511,6025860599,690.746119
2014,Thriller,1677508423,5617467937,3939959514,1238.241902
2014,War,502800000,1995998811,1493198811,158.135329
2014,Western,26500000,45512853,19012853,15.628851000000001
2015,Action,3676184325,14741794557,11065610232,776.570543
2015,Adventure,3882548152,14787066067,10904517915,1209.9708669999998
2015,Animation,913143149,4070143944,3157000795,677.002124
2015,Comedy,2036240865,7928886653,5892645788,1240.446683
2015,Crime,1141925000,2751272884,1609347884,313.6307570000001
2015,Documentary,400000,88097,-311903,0.984906
2015,Drama,2569385967,7925823475,5356437508,1083.882816
2015,Family,1237083149,4602753819,3365670670,708.55041
2015,Fantasy,1167000003,4618893447,3451893444,204.689298
2015,History,325884375,602329556,276445181,110.502745
2015,Horror,241700000,930442512,688742512,204.225208
2015,Music,134800000,695793417,560993417,107.731727
2015,Mystery,547200000,871699102,324499102,186.60884499999997
2015,Romance,475040000,1895534132,1420494132,247.103056
2015,Science Fiction,2369620003,9350128399,6980508396,498.30898499999995
2015,Thriller,1904884322,6896211670,4991327348,689.7735359999998
2015,War,154800000,300464656,145664656,88.195445
2015,Western,179000000,688710620,509710620,43.83005
2016,Action,4428543507,12214796195,7786252688,1243.7019469999996
2016,Adventure,4830031653,16089707582,11259675929,1202.5635309999998
2016,Animation,1404531653,6352317178,4947785525,250.37239100000002
2016,Comedy,2721864263,9216355143,6494490880,945.0974279999998
2016,Crime,886812373,2422481371,1535668998,339.6949840000001
2016,Documentary,5000000,13000000,8000000,1.628629
2016,Drama,2760697391,7151960719,4391263328,1209.8822469999998
2016,Family,2172000000,8692394144,6520394144,364.3127560000001
2016,Fantasy,2354251653,7355293594,5001041941,419.391396
2016,History,480550000,752428653,271878653,184.160692
2016,Horror,309020000,1969679291,1660659291,341.75411600000007
2016,Music,182000000,1102571275,920571275,61.606603
2016,Mystery,262780132,1007658570,744878438,172.677006
2016,Romance,655126653,2368818566,1713691913,298.62997199999995
2016,Science Fiction,2049720000,7098280655,5048560655,521.217643
2016,Thriller,1393906695,3817948879,2424042184,762.2724039999999
2016,War,378656348,567089190,188432842,97.64707200000001
2016,Western,137000000,201351716,64351716,41.129456
2017,Action,2903991676,10354079382,7450087706,1655.1820870000001
2017,Adventure,1972046714,6756597316,4784550602,946.5297790000002
2017,Animation,608000000,2555920591,1947920591,225.471946
2017,Comedy,1384972803,5177611983,3792639180,739.3142240000001
2017,Crime,542000000,2360330555,1818330555,486.874556
2017,Drama,961856338,2768909983,1807053645,818.8966149999999
2017,Family,812000000,4053574395,3241574395,550.766381
2017,Fantasy,1081100000,4240999485,3159899485,907.6696149999999
2017,History,165075038,773465607,608390569,67.39115799999999
2017,Horror,300700000,840498966,539798966,319.40725
2017,Music,10000000,443684,-9556316,12.928712
2017,Mystery,132800000,733041828,600241828,170.229744
2017,Romance,347845300,1685506844,1337661544,400.26605000000006
2017,Science Fiction,1422271676,3326604343,1904332667,818.658697
2017,Thriller,1259400000,4184887259,2925487259,782.260432
2017,War,362745300,1132756601,770011301,220.931957
2017,Western,70500000,96442939,25942939,87.164103
